11111111
1001PC11
10M00011
11100001
1CC0E101
11111101
11111111